50
# |
############
#          #
#          #          |
#
#          #
#          #
############
           #
           #
           #
           ##########
           